4444444444444444444444444
3000200101000011555555553
3020102222220011222021103
3000100020011011002021103
3211200020111020002022203
3000000020200020000000003
3222122111221220121212103
3010001020200020101010103
3011211020111020121212103
3022222020011010000000003
3021112020000010001111003
3001010011221222212222213
3122122120210120101020103
3555555520200010010020013
4444444444444444444444444